1111111111111111111111111111
100C000000000000000000000001
1000000000CC0000000000000001
10000C000C11C000002000000001
1000000001111000000000000001
1000000001111000000000020001
100000000111100000CC00000001
100P00000111100000E000000001
1000000001111000000000000001
1111111111111111111111111111