1111111111111111111111
1000000000000000000001
1000000000CC0000000001
100000000C11C000000001
1000000001111000000001
1000000001111000000001
1000000001111000000001
100P00000111100000E001
1000000001111000000001
1111111111111111111111