11111111111111
10000000000E00001
1111CCCCP00001
11111111111111