111111111
1000PP001
1C00000E1
111111111