111111111111111
100000011111P11
10C000110C00011
111000C000CF001
100000E00000001
111111111111111