1111111111111111111111111111
100C000000000000000000000001
1000000000CC000CC00020000001
10000C000C11C000000000000001
100C000001111000000020000001
100C000001111000000000000001
10000000011110000CCC0000C001
100P0000011110000CE00000C001
1000000001111000000000000001
1111111111111111111111111111