11111111111
1SADAVNKDF1
100P00C0E01
11111111111